ا	A
ب	B
ت	T
ث	TH
ج	J
ح	H
خ	KH
د	D
ذ	TH
ر	R
ز	Z
س	S
ش	SH
ص	S
ض	D
ط	DT
ظ	TH
ع	AH
غ	RI
ف	F
ق	Q
ك	C
ك	K
ل	L
م	M
ن	N
ه	H
و	W
ي	Y
ء	O
َ	A
ُ	U
ِ	I
